NO ./assets/textures/sky2A.png
SO ./assets/textures/sky2A.png
WE ./assets/textures/sky2A.png

C 44,5,88
EA ./assets/textures/sky2A.png

F 220,210,5

1111111111111111111111111111111
11110000000000001100001111000011
11001100000000000010000000000011
11000000000001110000000010000001
11111100000000001100000011000011
11010001000110010000000011001101
11110101011000001111000011111011
100000000000000S0000000110001001
11000011000000110001111110110011
11111100000111111111000011111111
10100010001000001100000011101001
11111110000000001111111011111011
11101010011111110111001111111101
11111111111111111111111111111111