NO ./assets/textures/wall1A.png
SO ./assets/textures/wall2A.png
WE ./assets/textures/wall3A.png
EA ./assets/textures/wall4A.png
F 220,100,0
C 225,30,0
1111111111111111111111111
1000000000110000000000001
1011000001110000000000001
1001000000000000000000001
11111111101100000111000011111
10000000001100000111011011111
11110111111111011100000000001
11110111111111011101010010001
11000000110101011100000010001
10000000000000001100000010001
10000000000000001101010010001
11000001110101011111011110S01
1111011111101011101111010001
11111111111111111111111111111